13
2 1 1 2 2 1 1 3 3
#######G#########
#######K#########
########K########
#####---H--######
###k--#-##---k###
#######T#########
######----t######
######-##########
######-##########
######K##########
#--P--------#####
###------k-######
#################
