12
2 3 4 2 4 2 4 1 2
#######################
#H-H----k---------FFFF#
#---------------------#
###########T###########
#t#----------------H--#
#H#-----------------###
#-------------------KG#
########-----H------###
#-----------t----FFFFF#
##-----------####-----#
#P--------------------#
#######################
