16
1 2 1 1 2 2 3 1
################
#--P-----------#
#------------kH#
#--FFFF-----FFF#
#--------------#
#######K########
#--i-----------#
#------H########
#----i----###--#
########-------#
#---------WW##-#
#H------t####--#
######---------#
##########T#####
#G-------------#
################
