20
1 2 3 1 1 5 2 1 1 2 2 2 1
################
#-----H--k-----#
#--------H-----#
#--FFFF-----FFF#
#--------------#
#######T########
#######-########
#--H-------FFFF#
#-----t--------#
####K###########
#--t------H---t#
#------H########
#p---t----###--#
########-------#
#---------WW##-#
#H------t####k-#
######---------#
##########K#####
#G-------------#
################
