11
3 19 2 11 3 1 1 1 2 1 2 1 2 1 1
######################
##t########G##########
##-########Z##########
##-###############Z###
#----------FF--t--T--#
##H---------H--------#
######---H-----#######
#t------------H------#
##########H###########
#p--------------—----#
######################
