11
3 19 2 11 1 1 2 4 3 1 1
######################
###########G##########
###########Z##########
##################Z###
#--------------t--T--#
##H---------H---F----#
######---H-----#######
#--------------------#
##########K###########
#p------------------K#
######################
