15
1 13 1 2 1 1 1 4 1 2 2 3 7 24 1 1 1 2 5 24 1 2 3 3 1 1 2 1 2 
#########################
#Z----Hk----#Z----------#
#--##-------#WWWWWWWWFFF#
#-------H---#-----H-----#
#H----------#----H------#
#-----------#----------Z#
#######-#################
#I----H-----#H---------Z#
#H----------#-----------#
###---------#t-----t----#
#G#------H--#-----------#
#T#---------#-----------#
#K#----P----#-----------#
#----H------#--t--H-----#
#########################
