16
1 4 1 1 2 1 2 1 3
##P#############
#--------------#
#------------KH#
#--FFFF-----FFF#
#--------------#
#######K########
#--i-----------#
#------H########
#----i----###--#
########-------#
#---------WW##-#
#H------i####--#
######---------#
##########T#####
#G-------------#
################
