11
3 19 2 11 3 1 1 1 2 1 1 2 
######################
##t########G##########
##-########Z##########
##-###############Z###
#--------------t--T--#
##H---------H---F----#
######---H-----#######
#t------------H------#
##########K###########
#p------------------K#
######################
