15
1 3 1 2 1 1 1 4 1 2 3 7 24 1 1 2 5 24 3 1 1 2
#########################
#Z----Hk----#Z----------#
#-----------#----WWWW---#
#-------H---#-----H-----#
#-----------#----H------#
#-----------#----------Z#
#######-#################
#-----H-----#H---------Z#
#-----------#-----------#
###---------#i-----i----#
#G#---------#-----------#
#T#---------#-----------#
#K#---------#-----------#
#----P------#--i--H-----#
#########################
