11
3 19 2 11 1 1 2 3 3 1 1
######################
###########G##########
###########Z##########
##################Z###
#---------G----t-T---#
##H---------H---F----#
######---H-----#######
#--------------------#
##########K###########
#p------------------K#
######################
