13
2 1 2 1 3 3
#######G#########
#######-K########
########K########
#####------######
###k--#-##---k###
#######T#########
######----t######
######-##########
######-##########
######K##########
#--p--------#####
###------k-######
#################