11
1 2 1 2 1 2 1 1
######################
#################-Z-G#
######################
##################Z###
#--------------t--T--#
##H---------H---F----#
######---H-----#######
#--------------------#
##########K###########
#P------------------k#
######################
