18
1 1 1 2 1 2 3 1 2 1 2 1 2 1 1 1 1 1 1 2 1 2 1 2 2 1 1 
####################
####I-###G##########
####H-###-#IH---####
####--###T#----H####
####--##---###--####
####--##H--###--####
#t-K------------K-t#
####-H---P------####
####WW##---###FF####
####WW##---###FF####
####H-###-####k-####
####--##-H-#########
####--##---#########
####--##H--#########
####--##--H#########
####--##---#########
####kH##-t-#########
####################