16
1 4 1 1 2 1 2 1 3
################
#P-------------#
#------------kH#
#--FFFF-----FFF#
#--------------#
#######K########
#--t-----------#
#------H########
#----t----###--#
########-------#
#---------WW##-#
#H------t####--#
######---------#
##########T#####
#G-------------#
################