16
3 4
##########
####-P-###
####---###
####-V-###
##########
#t------t#
#-##--##-#
#-#----#-#
#-#----#-#
#---H----#
#-#----#-#
#-#----#-#
#-##--##-#
#t------t#
#####T####
#####G####
##########