10
1 1 3 1 2 7 8 5 8
#######################
#P----#---H-----------#
#-----#---------------#
#----H#---------------#
#-----#H--------------#
#-----#-------------#-#
#-----#---------------#
#----###--------------#
#----Z#Z-------------G#
#######################