23
1 1 1 2 1 1 1 1 2 1 1 2 1 1 1 2 1 2 1 1 1 1 1 1 1 2 1 1 1 2 1 2 1 1 1 2 1 2 1 1 1 2 1 2 1 1 1 1 1 1 1 1 1 1 2
########################
#-----V#G###V---------H#
#H-----#T###-----------#
#------#P-H##########--#
#--H---#---#H-----K-#--#
#------#-H-#-----V#t#--#
#----H-#-#-#--#######--#
#------#---#-----------#
#--H---#H--#-H-------H-#
#------##--#############
#H-----#H--#############
#------#---#############
#----H-#--##############
#--H---#--H#############
#H-----#---#-------V---#
#------##--#-----------#
#--H---#-H--#----------#
#-H----#-#-#-----------#
#H-----#---#-----------#
#------#--##----------H#
###----#---#H--------###
#kF-----H--#I-------HKk#
########################