13
2 1 2 1 1 3 3
#################
#######GK########
########K########
#####------######
###k--#-##---k###
#######T#########
######----t######
######-##########
######-##########
######K##########
#--P--------#####
###------k-######
#################