10
1 1  02 
########################
#G#######t------------k#
#K#######-----#####----#
#-------T-----F--------#
###############-########
#---------------------t#
#-#############--------#
#---------##############
#---------##############
########################
